###############################
#p     ** * 1  * 2 *  * * *   #
# # # #*# # #*#*# # # #*#*#*# #
#  x*     ***  *  3   * 2 * * #
# # # # # #*# # #*#*# # # # #*#
#f   1     x **  *  *         #
# # # # # # # # # #*# #*# # # #
#*  *      *  *      *        #
# # # # #*# # # #*#*# # # # # #
#*    s*  *       n     1     #
# #*# # # # # # #*# # # # # # #
#           *   *  *          #
###############################