###############################
#p  n* n* *        *  * * *   #
# # # #*# # #*#*# # # #*#*#*# #
#   *     *x*  *      *   * * #
# # # # # #*# # #*#*# # # # #*#
#f 1    1  x **  *  *    f*   #
# # # # # # # # # #*# #*# # # #
#*  * *s   *  *      *   3    #
# # # # #*# # # #*#*# # # # # #
#* 2  s*  *   n   n   *  3    #
# #*# # # # # # #*# # # # # # #
#   **   2  *  f*  s          #
###############################