###############################
#p * *2    1  *  ** * *  1   *#
# # # # #*# # #*# # # # # #*# #
#f   s * *** **  n   *    **  #
# #*# # # # # # # # # # # # #*#
#   s      * 1   **   1  *  **#
# # #*# # # # # #*#*#*#*# # # #
#   *    2   *   * *x* *  1   #
# # # # #*# # # # # # #*# #*# #
#   f***    n    *1      1    #
# # # # # # # # # #*# # # # #*#
#  ** *   *  *   *      2     #
###############################