###############################
#p     ** * 1  *   *  * * *   #
# # # #*# # #*#*# # # #*#*#*# #
#  x*     ***  *  3   *   * * #
# # # # # #*# # #*#*# # # # #*#
#f   1     x **  *  *         #
# # # # # # # # # #*# #*# # # #
#*  *         *    2 *        #
# # # # #*# # # #*#*# # # # # #
#*    s*  *       n     1     #
# #*# # # # # # #*# # # # # # #
#           *   *  *          #
###############################