###############################
#p * *1    1  *  ** * *  1   *#
# # # # #*# # #*# # # # # #*# #
#f   s * *** **  n   *    **  #
# #*# # # # # # # # # # # # #*#
#   s   2  * 1   **   1  *  **#
# # #*# # # # # #*#*#*#*# # # #
#   *    2   *   * *x* *  1   #
# # # # #*# # # # # # #*# #*# #
#   f***    n    *1  3   1    #
# # # # # # # # # #*# # # # #*#
#  ** *   *3 *   *      2     #
###############################