###############################
#p  n* n* * 2    2 *  * * *   #
# # # #*# # #*#*# # # #*#*#*# #
#  f*     *x*  *      * 2 * * #
# # # # # #*# # #*#*# # # # #*#
#f   1   2 x **  *  *    f*   #
# # # # # # # # # #*# #*# # # #
#*  * *s   *  *      *        #
# # # # #*# # # #*#*# # # # # #
#*    s*  *   n   n   *   2   #
# #*# # # # # # #*# # # # # # #
#   ****   **  f*  s    1 1   #
###############################